viewname en Weapon trader
viewname ru Оружейный магазин
dataw 9
datah 17
beginmapdata
000	000	000	000	000	000	000	000	000
000	001 001 001	001	001	001	001	000
000	001	002	002	002	002	002	001	000
000	001	002	010	002	010	002	001	000
000	001	002	002	002	002	002	001	000
000	001	100	100	100	100	100	001	000
000	001	100	100	100	100	100	001	000
000	001	200	201	200	200	200	001	000
000	001	100	100	100	100	100	001	000
000	001	100	100	100	100	100	001	000
000	001	100	100	100	100	100	001	000
000	001	100	001	100	001	100	001	000
000	001	001	001	100	001	001	001	000
000	015	015	015	100	015	015	015	000
000	015	002	015	100	015	002	015	000
000	015	015	015	100	015	015	015	000
000	000	000	000	000	000	000	000	000
endmapdata
begineventdata

endeventdata
1045-1900-1717-0453-2909-7020